000000000000000000000000000000000000000000000000
000000000000000000000000000000000000000000000000
000000000000000000000000000000000000000000000000
000000000001000000000000000000000000000000000000
000000000011110000000000000000000000000000000000
000000000011111000000000000000000000000000111100
000000000000111110000000000000000000000000111100
000000000000011111000000000000000000000000111100
000000000000000111100000000000000000000000111100
000000000000000011100000000000000000000000000000
000000000000000001000000000000000000000000000000
000000000000000000000000000000000000000000000000
000000000000000000000000000000000000000000000000
000000000000000000000000000000000000000000000000
000000000000000000000000000000000000000000000000
000000000000000000000000000000000000000000000000
000111100000000000000000000000111000000000000000
000111100000000000000000000000111100000000000000
000111100000000000000000000000011110000000000000
000111100000000000000000000000001111100000000000
000111100000000000000000000000000111110000000000
000000000000000000000000000000000001111100000000
000000000000000000000000000000000000111000000000
000000000000000000000000000000000000000000000000
000000000000000000000000000000000000000000000000
000000000000000000000000000000000000000000000000
